....................
....................
........C.X.C.......
.......######.......
C.G..............GC.
####..G.G.G.G....###
.......G.GCGCG......
......--------......
...--...........--..
....................
.GCG............GCG.
####............####
....................
.1..................
####################
